Id;Bogføringsdag;Handelsdag;Valørdag;Transaktionstype;Værdipapirer;Instrumenttyp;ISIN;Antal;Kurs;Rente;Afgifter;Beløb;Valuta;Indkøbsværdi;Resultat;Totalt antal;Saldo;Vekslingskurs;Transaktionstekst;Makuleringsdato;Verifikations-/Notanummer
527121143;2018-12-31;2018-12-31;2019-01-01;OVERBELÅNINGSRENTE;;;;0;0,00;0,0000;0,00;-0,03;DKK;0,00;0,00;0,00;-33,63;1,00;;;226907181
527041936;2018-12-31;2018-12-31;2019-01-01;DEPOTRENTE;;;;0;0,00;0,0000;0,00;-0,03;DKK;0,00;0,00;0,00;-33,60;1,00;;;226907180
526097763;2018-12-21;2018-12-21;2018-12-28;KØBT;IVSO;Aktie;SE0001200015;158;57,50;0,0000;42,94;-6.656,00;DKK;34.403,00;0,00;578,00;-33,57;0,73;;;611540073
526096234;2018-12-21;2018-12-21;2018-12-28;SOLGT;TRMD A;Aktie;GB00BZ3CNK81;150;43,50;0,0000;29,00;6.496,00;DKK;22.462,39;-5.983,11;270,00;6.622,43;1,00;;;611539309
525809571;2018-12-20;2018-12-20;2018-12-27;KØBT;DNORD;Aktie;DK0060083210;110;90,00;0,0000;29,00;-9.929,00;DKK;73.526,40;0,00;667,00;126,43;1,00;;;611437078
525809168;2018-12-20;2018-12-20;2018-12-27;KØBT;PNDORA;Aktie;DK0060252690;40;268,4000;0,0000;29,00;-10.765,00;DKK;107.241,50;0,00;190,00;10.055,43;1,00;;;611436876
525436782;2018-12-19;2018-12-19;2018-12-19;INDBETALING;;;;0;0,00;0,0000;0,00;20.000,00;DKK;0,00;0,00;0,00;20.820,43;1,00;OVERFORSEL BAS;;226772809
523277143;2018-12-07;2018-11-29;2018-12-06;UDB.;TNP;Aktie;BMG9108L1081;2.250;0,05;0,0000;0,00;738,18;DKK;0,00;0,00;0,00;820,43;1,00;UDBYTTE TNP 0.05 USD/AKSJE;;226646885
518598663;2018-11-19;2018-11-19;2018-11-21;KØBT;NKT;Aktie;DK0010287663;126;84,35;0,0000;10,63;-10.638,73;DKK;33.087,73;0,00;316,00;82,25;1,00;;;608852301
518236235;2018-11-16;2018-11-16;2018-11-16;INDBETALING;;;;0;0,00;0,0000;0,00;10.000,00;DKK;0,00;0,00;0,00;10.720,98;1,00;OVERFORSEL;;226312224
518080353;2018-11-15;2018-11-12;2018-11-16;KUPSKAT;HM B;Aktie;SE0000106270;157;0,00;15,0000;0,00;-83,05;DKK;0,00;0,00;0,00;720,98;1,00;UDBYTTE HM B 4,85 SEK/AKSJE;;226300405
518080351;2018-11-15;2018-11-12;2018-11-16;UDB.;HM B;Aktie;SE0000106270;157;4,8500;0,0000;0,00;553,66;DKK;0,00;0,00;0,00;804,03;1,00;UDBYTTE HM B 4,85 SEK/AKSJE;;226300405
517340377;2018-11-13;2018-11-13;2018-11-15;KØBT;NKT;Aktie;DK0010287663;190;118,00;0,0000;29,00;-22.449,00;DKK;22.449,00;0,00;190,00;250,37;1,00;;;608426161
517319866;2018-11-13;2018-11-13;2018-11-15;SOLGT;ISS;Aktie;DK0060542181;100;226,20;0,0000;29,00;22.591,00;DKK;0,00;-862,00;0,00;22.699,37;1,00;;;608416101
510805959;2018-10-16;2018-10-16;2018-10-18;KØBT;DNORD;Aktie;DK0060083210;110;91,50;0,0000;29,00;-10.094,00;DKK;63.597,40;0,00;557,00;108,37;1,00;;;605948903
510120029;2018-10-12;2018-10-12;2018-10-12;RENSNING OVERF. VP;STENO ANSØGNING;Aktie;ZZ0061078425;1.136;0,00;0,0000;0,00;0,00;DKK;0,00;0,00;0,00;10.202,37;1,00;RENSNING STENO ANSØGNING;;56697679
509411160;2018-10-10;2018-10-10;2018-10-12;KØBT;IC;Aktie;DK0010221803;180;54,30;0,0000;29,00;-9.803,00;DKK;42.106,00;0,00;395,00;10.202,37;1,00;;;605402434
509292245;2018-10-10;2018-10-10;2018-10-10;EMISSION INDLÆG  VP;STENO ANSØGNING;Aktie;ZZ0061078425;1.136;0,00;0,0000;0,00;0,00;DKK;0,00;0,00;1.136,00;20.005,37;1,00;ÖNSKAR TECKNA STENOCARE;;56689226
509226921;2018-10-10;2018-10-10;2018-10-10;INDBETALING;;;;0;0,00;0,0000;0,00;10.000,00;DKK;0,00;0,00;0,00;20.005,37;1,00;OVERFORSEL BAS;;225770092
507026260;2018-10-02;2018-10-02;2018-10-02;INDBETALING;;;;0;0,00;0,0000;0,00;9.000,00;DKK;0,00;0,00;0,00;10.005,37;1,00;OVERFORSEL BAS;;225524736
506790684;2018-10-01;2018-09-27;2018-10-01;UDBYTTESKAT;IC;Aktie;DK0010221803;215;0,00;27,0000;0,00;-316,95;DKK;0,00;0,00;0,00;1.005,37;1,00;UDBYTTE IC 5.46 DKK/AKSJE;;225441539
506790682;2018-10-01;2018-09-27;2018-10-01;UDB.;IC;Aktie;DK0010221803;215;5,46;0,0000;0,00;1.173,90;DKK;0,00;0,00;0,00;1.322,32;1,00;UDBYTTE IC 5.46 DKK/AKSJE;;225441539
505246589;2018-09-26;2018-09-26;2018-09-28;KØBT;IVSO;Aktie;SE0001200015;420;60,00;0,0000;42,53;-18.208,00;DKK;25.259,00;0,00;420,00;148,42;0,72;;;604024066
504291472;2018-09-20;2018-09-18;2018-09-20;UDBYTTESKAT;IC;Aktie;DK0010221803;215;0,00;27,0000;0,00;-5.805,00;DKK;0,00;0,00;0,00;18.356,42;1,00;UDBYTTE IC 100 DKK/AKSJE;;225218282
504291470;2018-09-20;2018-09-18;2018-09-20;UDB.;IC;Aktie;DK0010221803;215;100,00;0,0000;0,00;21.500,00;DKK;0,00;0,00;0,00;24.161,42;1,00;UDBYTTE IC 100 DKK/AKSJE;;225218282
498267044;2018-08-24;2018-08-22;2018-08-24;UDBYTTESKAT;NNIT;Aktie;DK0060580512;180;0,00;27,0000;0,00;-97,20;DKK;0,00;0,00;0,00;2.661,42;1,00;UDBYTTE NNIT 2 DKK/AKSJE;;224829472
498267042;2018-08-24;2018-08-22;2018-08-24;UDB.;NNIT;Aktie;DK0060580512;180;2,00;0,0000;0,00;360,00;DKK;0,00;0,00;0,00;2.758,62;1,00;UDBYTTE NNIT 2 DKK/AKSJE;;224829472
498014979;2018-08-23;2018-08-21;2018-08-23;UDBYTTESKAT;PNDORA;Aktie;DK0060252690;150;0,00;27,0000;0,00;-364,50;DKK;0,00;0,00;0,00;2.398,62;1,00;UDBYTTE PNDORA 9 DKK/AKSJE;;224813047
498014977;2018-08-23;2018-08-21;2018-08-23;UDB.;PNDORA;Aktie;DK0060252690;150;9,00;0,0000;0,00;1.350,00;DKK;0,00;0,00;0,00;2.763,12;1,00;UDBYTTE PNDORA 9 DKK/AKSJE;;224813047
495266247;2018-08-09;2018-08-01;2018-08-08;UDB.;TNP;Aktie;BMG9108L1081;2.250;0,05;0,0000;0,00;724,11;DKK;0,00;0,00;0,00;1.413,12;1,00;UDBYTTE TNP 0.05 USD/AKSJE;;224678404
490019489;2018-07-12;2018-07-12;2018-07-16;KØBT;IC;Aktie;DK0010221803;65;158,00;0,0000;29,00;-10.299,00;DKK;32.303,00;0,00;215,00;689,01;1,00;;;598102141
489081789;2018-07-06;2018-07-06;2018-07-10;SOLGT;NAS;Aktie;NO0010196140;19;240,00;0,0000;46,61;3.555,67;DKK;0,00;1.556,00;0,00;10.988,01;0,79;;;597752002
488555231;2018-07-05;2018-07-05;2018-07-05;OMV. INDLÆG  VP;NAS;Aktie;NO0010196140;19;0,00;0,0000;0,00;2.945,00;NOK;2.945,00;0,00;19,00;0,00;0,79;TILLDELNING EMISSION NORWEGIAN AIR SHUTTLE 155 NOK/AK;;56608801
488555229;2018-07-05;2018-07-05;2018-07-05;OMV. OVERF.  VP;NAS TEGNING;Aktie;ZX0010196140;19;0,00;0,0000;0,00;0,00;NOK;0,00;0,00;0,00;0,00;0,79;TILLDELNING EMISSION NORWEGIAN AIR SHUTTLE 155 NOK/AK;;56608801
488115141;2018-07-03;2018-07-03;2018-07-05;KØBT;DNORD;Aktie;DK0060083210;100;110,90;0,0000;29,00;-11.119,00;DKK;53.503,40;0,00;447,00;7.432,34;1,00;;;597372641
486757458;2018-06-28;2018-06-28;2018-06-28;RENSNING OVERF. VP;NAS SØKNAD;Aktie;YX0010196140;100;0,00;0,0000;0,00;0,00;NOK;0,00;0,00;0,00;0,00;0,79;SLETTING NAS SØKNAD;;56602889
486753625;2018-06-28;2018-06-27;2018-06-29;KØBT;NAS TEGNING;Aktie;ZX0010196140;9;155,00;0,0000;0,00;-1.100,00;DKK;2.945,00;0,00;19,00;18.551,34;0,79;TECKNING NORWEGIAN AIR SHUTTLE 155 NOK/AK;;596984881
486158949;2018-06-25;2018-06-25;2018-06-25;TEGNING LIKVID;NAS TEGNING;Aktie;ZX0010196140;10;155,00;0,0000;0,00;-1.222,06;DKK;0,00;0,00;0,00;19.651,34;1,00;TECKNING NAS, 155 NOK/AK;;223892879
486158947;2018-06-25;2018-06-25;2018-06-25;TEGNING INDLÆG  VP;NAS TEGNING;Aktie;ZX0010196140;10;155,00;0,0000;0,00;-1.222,06;DKK;1.550,00;0,00;10,00;20.873,40;0,79;TECKNING NAS, 155 NOK/AK;;56598003
486158945;2018-06-25;2018-06-25;2018-06-25;TEGNING OVERF.  RETT;NAS T;Aktie;NO0010824147;10;0,00;0,0000;0,00;0,00;NOK;0,00;0,00;0,00;0,00;0,79;TECKNING NAS, 155 NOK/AK;;56598003
486152610;2018-06-25;2018-06-25;2018-06-25;EMISSION INDLÆG  VP;NAS SØKNAD;Aktie;YX0010196140;100;0,00;0,0000;0,00;0,00;NOK;0,00;0,00;100,00;0,00;0,79;ÖNSKAR TECKNA UTAN FÖRETRÄDE NORWEGIAN AIR SHUTTLE;;56597616
484134249;2018-06-13;2018-06-13;2018-06-13;INDBETALING;;;;0;0,00;0,0000;0,00;20.000,00;DKK;0,00;0,00;0,00;20.873,40;1,00;OVERFORSEL BAS;;223778121
483565607;2018-06-12;2018-03-21;2018-03-21;TILD. INDLÆG  RETTER;NAS T;Aktie;NO0010824147;10;0,00;0,0000;0,00;0,00;NOK;0,00;0,00;10,00;0,00;0,78;TILLDELNING TECKNINGSRÄTTER NAS;;56578732
481211868;2018-05-31;2018-05-25;2018-05-29;TYSK SOL SKAT UDB;DBK;Aktie;DE0005140008;350;0,00;1,3750;0,00;-3,94;DKK;0,00;0,00;0,00;873,40;1,00;UDBYTTE DBK 0.11 EUR/AKSJE;;223581167
481211866;2018-05-31;2018-05-25;2018-05-29;UDBYTTESKAT;DBK;Aktie;DE0005140008;350;0,00;25,0000;0,00;-71,64;DKK;0,00;0,00;0,00;877,34;1,00;UDBYTTE DBK 0.11 EUR/AKSJE;;223581167
481211864;2018-05-31;2018-05-25;2018-05-29;UDB.;DBK;Aktie;DE0005140008;350;0,11;0,0000;0,00;286,55;DKK;0,00;0,00;0,00;948,98;1,00;UDBYTTE DBK 0.11 EUR/AKSJE;;223581167
478098509;2018-05-17;2018-05-17;2018-05-21;KØBT;ACARIX;Aktie;SE0009268717;1.000;9,1195;0,0000;42,85;-6.665,00;DKK;19.185,00;0,00;1.812,00;662,43;0,73;;;594033960
478084754;2018-05-17;2018-05-17;2018-05-22;KØBT;MAERSK B;Aktie;DK0010244508;2;9.000,00;0,0000;29,00;-18.029,00;DKK;78.707,66;0,00;8,00;7.327,43;1,00;;;594027092
477751622;2018-05-16;2018-05-16;2018-05-18;KØBT;PNDORA;Aktie;DK0060252690;24;550,00;0,0000;29,00;-13.229,00;DKK;96.476,50;0,00;150,00;25.356,43;1,00;;;593929752
477743810;2018-05-16;2018-05-16;2018-05-18;SOLGT;NKT;Aktie;DK0010287663;100;174,50;0,0000;29,00;17.421,00;DKK;0,00;542,00;0,00;38.585,43;1,00;;;593926002
477466530;2018-05-15;2018-05-09;2018-05-16;KUPSKAT;HM B;Aktie;SE0000106270;157;0,00;15,0000;0,00;-83,50;DKK;0,00;0,00;0,00;21.164,43;1,00;UDBYTTE HM B 4.9 SEK/AKSJE;;223374537
477466528;2018-05-15;2018-05-09;2018-05-16;UDB.;HM B;Aktie;SE0000106270;157;4,9000;0,0000;0,00;556,66;DKK;0,00;0,00;0,00;21.247,93;1,00;UDBYTTE HM B 4.9 SEK/AKSJE;;223374537
477263860;2018-05-15;2018-05-15;2018-05-17;KØBT;NKT;Aktie;DK0010287663;100;168,50;0,0000;29,00;-16.879,00;DKK;16.879,00;0,00;100,00;20.691,27;1,00;;;593835335
476755717;2018-05-11;2018-05-02;2018-05-10;UDB.;TNP;Aktie;BMG9108L1081;2.250;0,05;0,0000;0,00;703,99;DKK;0,00;0,00;0,00;37.570,27;1,00;UDBYTTE TNP 0.05 USD/AKSJE;;223337193
476273340;2018-05-09;2018-05-09;2018-05-14;SOLGT;NAS;Aktie;NO0010196140;150;299,6000;0,0000;45,42;34.552,24;DKK;0,00;3.862,53;0,00;36.866,28;0,77;;;593527118
467689022;2018-04-16;2018-04-12;2018-04-16;UDBYTTESKAT;ISS;Aktie;DK0060542181;100;0,00;27,0000;0,00;-207,90;DKK;0,00;0,00;0,00;2.314,04;1,00;UDBYTTE ISS 7.7 DKK/AKSJE;;222961784
467689020;2018-04-16;2018-04-12;2018-04-16;UDB.;ISS;Aktie;DK0060542181;100;7,70;0,0000;0,00;770,00;DKK;0,00;0,00;0,00;2.521,94;1,00;UDBYTTE ISS 7.7 DKK/AKSJE;;222961784
467061401;2018-04-13;2018-04-11;2018-04-13;UDBYTTESKAT;MAERSK B;Aktie;DK0010244508;6;0,00;27,0000;0,00;-243,00;DKK;0,00;0,00;0,00;1.751,94;1,00;UDBYTTE MAERSK B 150 DKK/AKSJE;;222912880
467061399;2018-04-13;2018-04-11;2018-04-13;UDB.;MAERSK B;Aktie;DK0010244508;6;150,00;0,0000;0,00;900,00;DKK;0,00;0,00;0,00;1.994,94;1,00;UDBYTTE MAERSK B 150 DKK/AKSJE;;222912880
463466542;2018-03-30;2018-03-30;2018-04-01;OVERBELÅNINGSRENTE;;;;0;0,00;0,0000;0,00;-0,12;DKK;0,00;0,00;0,00;1.094,94;1,00;;;222650159
463381477;2018-03-30;2018-03-30;2018-04-01;DEPOTRENTE;;;;0;0,00;0,0000;0,00;-0,12;DKK;0,00;0,00;0,00;1.095,06;1,00;;;222650158
460513446;2018-03-19;2018-03-15;2018-03-19;UDBYTTESKAT;PNDORA;Aktie;DK0060252690;126;0,00;27,0000;0,00;-306,18;DKK;0,00;0,00;0,00;1.095,18;1,00;UDBYTTE PNDORA 9 DKK/AKSJE;;222483098
460513444;2018-03-19;2018-03-15;2018-03-19;UDB.;PNDORA;Aktie;DK0060252690;126;9,00;0,0000;0,00;1.134,00;DKK;0,00;0,00;0,00;1.401,36;1,00;UDBYTTE PNDORA 9 DKK/AKSJE;;222483098
459388373;2018-03-13;2018-03-09;2018-03-13;UDBYTTESKAT;NNIT;Aktie;DK0060580512;180;0,00;27,0000;0,00;-111,78;DKK;0,00;0,00;0,00;267,36;1,00;UDBYTTE NNIT 2.3 DKK/AKSJE;;222430287
459388371;2018-03-13;2018-03-09;2018-03-13;UDB.;NNIT;Aktie;DK0060580512;180;2,3000;0,0000;0,00;414,00;DKK;0,00;0,00;0,00;379,14;1,00;UDBYTTE NNIT 2.3 DKK/AKSJE;;222430287
456471976;2018-02-28;2018-02-28;2018-03-01;OVERBELÅNINGSRENTE;;;;0;0,00;0,0000;0,00;-0,19;DKK;0,00;0,00;0,00;-34,86;1,00;;;222222291
456389953;2018-02-28;2018-02-28;2018-03-01;DEPOTRENTE;;;;0;0,00;0,0000;0,00;-0,19;DKK;0,00;0,00;0,00;-34,67;1,00;;;222222290
452845863;2018-02-08;2018-02-08;2018-02-12;KØBT;DBK;Aktie;DE0005140008;100;13,0870;0,0000;89,51;-9.851,44;DKK;6.159,20;0,00;350,00;-34,48;7,46;;;587054807
452358782;2018-02-07;2018-02-07;2018-02-09;KØBT;ISS;Aktie;DK0060542181;45;227,90;0,0000;29,00;-10.284,50;DKK;23.453,00;0,00;100,00;9.816,96;1,00;;;586857451
451780751;2018-02-06;2018-02-06;2018-02-06;INDBETALING;;;;0;0,00;0,0000;0,00;20.000,00;DKK;0,00;0,00;0,00;20.101,46;1,00;OVERFORSEL BAS;;221971547
448046271;2018-01-23;2018-01-23;2018-01-25;KØBT;WNT;Aktie;SE0003553130;300;10,80;0,0000;44,72;-2.501,00;DKK;6.246,00;0,00;475,00;101,46;0,76;;;585155979
445588826;2018-01-11;2018-01-11;2018-01-15;KØBT;PNDORA;Aktie;DK0060252690;20;569,00;0,0000;29,00;-11.409,00;DKK;83.247,50;0,00;126,00;2.602,46;1,00;;;584129444
445562193;2018-01-11;2018-01-11;2018-01-15;KØBT;ISS;Aktie;DK0060542181;55;238,90;0,0000;29,00;-13.168,50;DKK;13.168,50;0,00;55,00;14.011,46;1,00;;;584116338
443047175;2018-01-02;2017-12-20;2018-01-01;UDB.;TNP;Aktie;BMG9108L1081;2.250;0,05;0,0000;0,00;695,43;DKK;0,00;0,00;0,00;27.179,96;1,00;UDBYTTE TNP 0.05 USD/AKSJE;;221392146
441361700;2017-12-27;2017-12-27;2017-12-29;SOLGT;NOVO B;Aktie;DK0060534915;72;338,00;0,0000;29,00;24.307,00;DKK;0,00;1.997,20;0,00;26.484,53;1,00;;;582658657
436568743;2017-12-18;2017-12-18;2017-12-20;KØBT;ACARIX;Aktie;SE0009268717;812;12,25;0,0000;44,17;-7.491,00;DKK;10.006,00;0,00;812,00;2.177,53;0,75;;;582038306
435933769;2017-12-14;2017-12-14;2017-12-18;KØBT;NNIT;Aktie;DK0060580512;180;168,50;0,0000;30,33;-30.360,33;DKK;30.360,33;0,00;180,00;9.668,53;1,00;;;581793472
435567743;2017-12-13;2017-12-13;2017-12-15;SOLGT;NETS;Aktie;DK0060745370;184;163,50;0,0000;30,08;30.053,92;DKK;0,00;2.453,92;0,00;40.028,86;1,00;;;581662475
435251626;2017-12-12;2017-12-12;2017-12-14;KØBT;DNORD;Aktie;DK0060083210;125;113,60;0,0000;29,00;-14.229,00;DKK;42.384,40;0,00;347,00;9.974,94;1,00;;;581538401
435250566;2017-12-12;2017-12-12;2017-12-14;SOLGT;NOVO B;Aktie;DK0060534915;72;334,00;0,0000;29,00;24.019,00;DKK;22.309,80;1.709,20;72,00;24.203,94;1,00;;;581537870
432780648;2017-12-01;2017-12-01;2017-12-05;KØBT;DNORD;Aktie;DK0060083210;32;116,70;0,0000;29,00;-3.763,40;DKK;28.155,40;0,00;222,00;184,94;1,00;;;580567544
429610468;2017-11-16;2017-11-13;2017-11-17;KUPSKAT;HM B;Aktie;SE0000106270;157;0,00;0,0000;0,00;-85,68;DKK;0,00;0,00;0,00;3.948,34;1,00;UDBYTTE HM B 4.85 SEK/AKSJE;;220637107
429610466;2017-11-16;2017-11-13;2017-11-17;UDB.;HM B;Aktie;SE0000106270;157;4,8500;0,0000;0,00;571,23;DKK;0,00;0,00;0,00;4.034,02;1,00;UDBYTTE HM B 4.85 SEK/AKSJE;;220637107
429541618;2017-11-16;2017-11-08;2017-11-15;UDB.;TNP;Aktie;BMG9108L1081;2.250;0,05;0,0000;0,00;710,30;DKK;0,00;0,00;0,00;3.462,79;1,00;UDBYTTE TNP 0.05 USD/AKSJE;;220637081
429293211;2017-11-16;2017-11-14;2017-11-16;UDBYTTESKAT;PNDORA;Aktie;DK0060252690;106;0,00;0,0000;0,00;-257,58;DKK;0,00;0,00;0,00;2.752,49;1,00;UDBYTTE PNDORA 9 DKK/AKSJE;;220630579
429293209;2017-11-16;2017-11-14;2017-11-16;UDB.;PNDORA;Aktie;DK0060252690;106;9,00;0,0000;0,00;954,00;DKK;0,00;0,00;0,00;3.010,07;1,00;UDBYTTE PNDORA 9 DKK/AKSJE;;220630579
427357228;2017-11-07;2017-11-07;2017-11-09;KØBT;MAERSK B;Aktie;DK0010244508;1;11.300,00;0,0000;29,00;-11.329,00;DKK;60.678,66;0,00;6,00;2.056,07;1,00;;;578449618
427357188;2017-11-07;2017-11-07;2017-11-09;KØBT;PNDORA;Aktie;DK0060252690;20;580,00;0,0000;29,00;-11.629,00;DKK;71.838,50;0,00;106,00;13.385,07;1,00;;;578449598
427274240;2017-11-07;2017-11-07;2017-11-07;INDBETALING;;;;0;0,00;0,0000;0,00;25.000,00;DKK;0,00;0,00;0,00;25.014,07;1,00;OVERFORSEL BAS;;220540499
424961611;2017-10-30;2017-10-30;2017-11-01;KØBT;WNT;Aktie;SE0003553130;175;16,50;0,0000;45,31;-2.263,00;DKK;2.947,00;0,00;175,00;14,07;0,77;;;577555047
418220414;2017-10-04;2017-09-28;2017-10-02;UDBYTTESKAT;IC;Aktie;DK0010221803;150;0,00;0,0000;0,00;-202,50;DKK;0,00;0,00;0,00;2.277,07;1,00;UDBYTTE IC 5 DKK/AK;;220092374
418220412;2017-10-04;2017-09-28;2017-10-02;UDB.;IC;Aktie;DK0010221803;150;5,00;0,0000;0,00;750,00;DKK;0,00;0,00;0,00;2.479,57;1,00;UDBYTTE IC 5 DKK/AK;;220092374
413112812;2017-09-12;2017-08-24;2017-09-12;UDB.;TRMD A;Aktie;GB00BZ3CNK81;420;0,1240;0,0000;0,00;52,06;DKK;0,00;0,00;0,00;1.729,57;1,00;UDBYTTE TRMD A 0.123954 DKK/AKSJE;;219685255
408193062;2017-08-22;2017-08-18;2017-08-22;UDBYTTESKAT;NOVO B;Aktie;DK0060534915;144;0,00;0,0000;0,00;-116,64;DKK;0,00;0,00;0,00;1.677,51;1,00;UDBYTTE NOVO B 3 DKK/AKSJE;;219396000
408193060;2017-08-22;2017-08-18;2017-08-22;UDB.;NOVO B;Aktie;DK0060534915;144;3,00;0,0000;0,00;432,00;DKK;0,00;0,00;0,00;1.794,15;1,00;UDBYTTE NOVO B 3 DKK/AKSJE;;219396000
407370503;2017-08-17;2017-08-15;2017-08-17;UDBYTTESKAT;PNDORA;Aktie;DK0060252690;86;0,00;0,0000;0,00;-208,98;DKK;0,00;0,00;0,00;1.362,15;1,00;UDBYTTE PNDORA 9 DKK/AKSJE;;219362683
407370501;2017-08-17;2017-08-15;2017-08-17;UDB.;PNDORA;Aktie;DK0060252690;86;9,00;0,0000;0,00;774,00;DKK;0,00;0,00;0,00;1.571,13;1,00;UDBYTTE PNDORA 9 DKK/AKSJE;;219362683
401768625;2017-07-17;2017-07-07;2017-07-14;UDB.;TNP;Aktie;BMG9108L1081;2.250;0,05;0,0000;0,00;731,10;DKK;0,00;0,00;0,00;797,13;1,00;UDBYTTE TNP 0.05 USD/AKSJE;;219014522
393157885;2017-06-02;2017-06-02;2017-06-07;KØBT;HM B;Aktie;SE0000106270;62;218,90;0,0000;45,13;-10.426,00;DKK;37.345,00;0,00;157,00;66,03;0,76;;;565614055
392838902;2017-06-01;2017-06-01;2017-06-06;KØBT;PNDORA;Aktie;DK0060252690;20;616,00;0,0000;29,00;-12.349,00;DKK;60.209,50;0,00;86,00;10.492,03;1,00;;;565511599
392836231;2017-06-01;2017-06-01;2017-06-05;SOLGT;IVSO;Aktie;SE0001200015;350;85,00;0,0000;44,77;22.531,00;DKK;0,00;9.232,02;0,00;22.841,03;0,76;;;565510262
391331242;2017-05-24;2017-05-19;2017-05-23;TYSK SOL SKAT UDB;DBK;Aktie;DE0005140008;250;0,00;0,0000;0,00;-4,86;DKK;0,00;0,00;0,00;310,03;1,00;UDBYTTE DBK 0.19 EUR/AKSJE;;218300398
391331240;2017-05-24;2017-05-19;2017-05-23;UDBYTTESKAT;DBK;Aktie;DE0005140008;250;0,00;0,0000;0,00;-88,39;DKK;0,00;0,00;0,00;314,89;1,00;UDBYTTE DBK 0.19 EUR/AKSJE;;218300398
391331238;2017-05-24;2017-05-19;2017-05-23;UDB.;DBK;Aktie;DE0005140008;250;0,19;0,0000;0,00;353,54;DKK;0,00;0,00;0,00;403,28;1,00;UDBYTTE DBK 0.19 EUR/AKSJE;;218300398
391026203;2017-05-23;2017-05-23;2017-05-29;KØBT;PNDORA;Aktie;DK0060252690;21;653,50;0,0000;29,00;-13.752,50;DKK;47.860,50;0,00;66,00;49,74;1,00;;;564886043
391016272;2017-05-23;2017-05-23;2017-05-26;SOLGT;IVSO;Aktie;SE0001200015;200;80,00;0,0000;44,96;12.149,00;DKK;20.458,98;4.250,16;350,00;13.802,24;0,76;;;564881081
390087289;2017-05-18;2017-05-16;2017-05-18;UDBYTTESKAT;PNDORA;Aktie;DK0060252690;45;0,00;0,0000;0,00;-109,35;DKK;0,00;0,00;0,00;1.653,24;1,00;UDBYTTE PNDORA 9 DKK/AKSJE;;218245596
390087287;2017-05-18;2017-05-16;2017-05-18;UDB.;PNDORA;Aktie;DK0060252690;45;9,00;0,0000;0,00;405,00;DKK;0,00;0,00;0,00;1.762,59;1,00;UDBYTTE PNDORA 9 DKK/AKSJE;;218245596
389664465;2017-05-16;2017-05-11;2017-05-17;KUPSKAT;HM B;Aktie;SE0000106270;95;0,00;0,0000;0,00;-53,57;DKK;0,00;0,00;0,00;1.357,59;1,00;UDBYTTE HM B 4.9 SEK/AKSJE;;218231243
389664463;2017-05-16;2017-05-11;2017-05-17;UDB.;HM B;Aktie;SE0000106270;95;4,9000;0,0000;0,00;357,14;DKK;0,00;0,00;0,00;1.411,16;1,00;UDBYTTE HM B 4.9 SEK/AKSJE;;218231243
386457272;2017-05-03;2017-04-27;2017-05-04;KUPSKAT;IVSO;Aktie;SE0001200015;550;0,00;0,0000;0,00;-31,88;DKK;0,00;0,00;0,00;1.054,02;1,00;UDBYTTE IVSO 0.5 SEK/AKSJE;;218114926
386457270;2017-05-03;2017-04-27;2017-05-04;UDB.;IVSO;Aktie;SE0001200015;550;0,50;0,0000;0,00;212,54;DKK;0,00;0,00;0,00;1.085,90;1,00;UDBYTTE IVSO 0.5 SEK/AKSJE;;218114926
385653415;2017-05-01;2017-04-21;2017-04-28;UDB.;TNP;Aktie;BMG9108L1081;2.250;0,05;0,0000;0,00;768,72;DKK;0,00;0,00;0,00;873,36;1,00;UDBYTTE TNP 0.05 USD/AKSJE;;218002289
378770813;2017-03-31;2017-03-31;2017-04-04;KØBT;IVSO;Aktie;SE0001200015;100;65,00;0,0000;46,08;-5.123,00;DKK;32.149,82;0,00;550,00;104,64;0,78;;;561013677
378593947;2017-03-31;2017-03-29;2017-03-31;UDBYTTESKAT;MAERSK B;Aktie;DK0010244508;5;0,00;0,0000;0,00;-202,50;DKK;0,00;0,00;0,00;5.227,64;1,00;UDBYTTE MAERSK B 150 DKK/AKSJE;;217592811
378593945;2017-03-31;2017-03-29;2017-03-31;UDB.;MAERSK B;Aktie;DK0010244508;5;150,00;0,0000;0,00;750,00;DKK;0,00;0,00;0,00;5.430,14;1,00;UDBYTTE MAERSK B 150 DKK/AKSJE;;217592811
377543613;2017-03-28;2017-03-24;2017-03-28;UDBYTTESKAT;NOVO B;Aktie;DK0060534915;144;0,00;0,0000;0,00;-178,85;DKK;0,00;0,00;0,00;4.680,14;1,00;UDBYTTE NOVO B 4.6 DKK/AKSJE;;217537174
377543611;2017-03-28;2017-03-24;2017-03-28;UDB.;NOVO B;Aktie;DK0060534915;144;4,6000;0,0000;0,00;662,40;DKK;0,00;0,00;0,00;4.858,99;1,00;UDBYTTE NOVO B 4.6 DKK/AKSJE;;217537174
377380619;2017-03-27;2017-03-27;2017-03-29;SOLGT;03KB;Aktie;DE000A2E4184;250;1,83;0,0000;89,06;3.306,34;DKK;0,00;445,50;0,00;4.196,59;7,42;;;560570387
376500332;2017-03-22;2017-03-22;2017-03-24;KØBT;PNDORA;Aktie;DK0060252690;15;740,00;0,0000;29,00;-11.129,00;DKK;34.108,00;0,00;45,00;890,25;1,00;;;560271951
376307851;2017-03-22;2017-03-21;2017-03-22;TILD. INDLÆG  RETTER;03KB;Aktie;DE000A2E4184;250;0,00;0,0000;0,00;0,00;EUR;0,00;0,00;250,00;0,00;7,43;ISSUE OF SUBSCRIPTIO RIGHTS 1 : 1;;56015217
376159685;2017-03-21;2017-03-21;2017-03-23;KØBT;PNDORA;Aktie;DK0060252690;30;765,00;0,0000;29,00;-22.979,00;DKK;22.979,00;0,00;30,00;12.019,25;1,00;;;560135802
376139727;2017-03-21;2017-03-21;2017-03-23;SOLGT;ALK B;Aktie;DK0060027142;35;960,00;0,0000;33,60;33.566,40;DKK;0,00;1.789,65;0,00;34.998,25;1,00;;;560125624
375939649;2017-03-20;2017-03-16;2017-03-20;UDBYTTESKAT;ALK B;Aktie;DK0060027142;35;0,00;0,0000;0,00;-47,25;DKK;0,00;0,00;0,00;1.431,85;1,00;UDBYTTE ALK B 5 DKK/AKSJE;;217456466
375939647;2017-03-20;2017-03-16;2017-03-20;UDB.;ALK B;Aktie;DK0060027142;35;5,00;0,0000;0,00;175,00;DKK;0,00;0,00;0,00;1.479,10;1,00;UDBYTTE ALK B 5 DKK/AKSJE;;217456466
373821579;2017-03-08;2017-03-08;2017-03-13;KØBT;TNP;Aktie;BMG9108L1081;750;4,4800;0,0000;91,86;-23.834,42;DKK;10.511,00;0,00;2.250,00;1.304,10;7,07;;;559215690
373612419;2017-03-08;2017-03-08;2017-03-08;INDBETALING;;;;0;0,00;0,0000;0,00;25.000,00;DKK;0,00;0,00;0,00;25.138,52;1,00;OVERFORSEL BAS;;217357111
366825705;2017-02-02;2017-02-02;2017-02-06;KØBT;NOVO B;Aktie;DK0060534915;24;229,90;0,0000;29,00;-5.546,60;DKK;44.619,60;0,00;144,00;138,52;1,00;;;556156070
358982940;2016-12-23;2016-12-14;2016-12-22;UDB.;TNP;Aktie;BMG9108L1081;1.500;0,05;0,0000;0,00;533,94;DKK;0,00;0,00;0,00;5.685,12;1,00;UDBYTTE TNP 0.05 USD/AKSJE;;216249946
358518794;2016-12-21;2016-12-21;2016-12-23;KØBT;IC;Aktie;DK0010221803;150;146,50;0,0000;29,00;-22.004,00;DKK;22.004,00;0,00;150,00;5.151,18;1,00;;;552728104
357685588;2016-12-16;2016-12-16;2016-12-16;INDBETALING;;;;0;0,00;0,0000;0,00;25.000,00;DKK;0,00;0,00;0,00;27.155,18;1,00;BASISBANK;;216186865
350870433;2016-11-11;2016-11-02;2016-11-10;UDB.;TNP;Aktie;BMG9108L1081;1.500;0,08;0,0000;0,00;819,80;DKK;0,00;0,00;0,00;2.155,18;1,00;UDBYTTE TNP 0.08 USD/AKSJE;;215801351
345365339;2016-10-14;2016-10-14;2016-10-18;KØBT;ALK B;Aktie;DK0060027142;35;907,00;0,0000;31,75;-31.776,75;DKK;31.776,75;0,00;35,00;1.335,38;1,00;;;547360283
344024998;2016-10-06;2016-10-06;2016-10-10;KØBT;NAS;Aktie;NO0010196140;100;286,00;0,0000;48,95;-23.775,56;DKK;41.018,48;0,00;150,00;33.112,13;0,83;;;546773320
343190970;2016-10-03;2016-10-03;2016-10-05;SOLGT;DANSKE;Aktie;DK0010274414;240;195,00;0,0000;46,80;46.753,20;DKK;0,00;4.889,20;0,00;56.887,69;1,00;;;546425115
341898328;2016-09-28;2016-09-28;2016-09-30;BYTTE INDLÆG  VP;NETS;Aktie;DK0060745370;184;0,00;0,0000;0,00;27.600,00;DKK;27.600,00;0,00;184,00;10.134,49;1,00;BYTE NETS TEMP TIL NETS;;55755701
341898326;2016-09-28;2016-09-28;2016-09-30;BYTTE OVERF. VP;NETS TEMP;Aktie;DK0060745453;184;0,00;0,0000;0,00;0,00;DKK;0,00;0,00;0,00;10.134,49;1,00;BYTE NETS TEMP TIL NETS;;55755701
341599752;2016-09-26;2016-09-26;2016-09-28;KØBT;NOVO B;Aktie;DK0060534915;50;295,9000;0,0000;29,00;-14.824,00;DKK;39.073,00;0,00;120,00;10.134,49;1,00;;;545896316
341284137;2016-09-23;2016-09-23;2016-09-23;RENSNING OVERF. VP;NETS OTA;Aktie;ZZ0060745453;300;0,00;0,0000;0,00;0,00;DKK;0,00;0,00;0,00;24.958,49;1,00;RENSNING NETS OTA;;55751546
341269691;2016-09-23;2016-09-23;2016-09-27;KØBT;NETS TEMP;Aktie;DK0060745453;184;150,00;0,0000;0,00;-27.600,00;DKK;27.600,00;0,00;184,00;24.958,49;1,00;IPO NETS 150 DKK/AK;;545763876
340934456;2016-09-21;2016-09-21;2016-09-21;EMISSION INDLÆG  VP;NETS OTA;Aktie;ZZ0060745453;300;0,00;0,0000;0,00;0,00;DKK;0,00;0,00;300,00;52.558,49;1,00;ÖNSKAR TECKNA NETS;;55747441
340259786;2016-09-15;2016-08-24;2016-09-15;UDB.;TRMD A;Aktie;GB00BZ3CNK81;420;2,6592;0,0000;0,00;1.116,85;DKK;0,00;0,00;0,00;52.558,49;1,00;UDBYTTE TRMD A 2,659164 DKK/AK;;215089447
339951577;2016-09-14;2016-09-14;2016-09-14;INDBETALING;;;;0;0,00;0,0000;0,00;50.000,00;DKK;0,00;0,00;0,00;51.441,64;1,00;OVERFORSEL - I;;215077225
335257292;2016-08-16;2016-08-12;2016-08-16;UDBYTTESKAT;NOVO B;Aktie;DK0060534915;70;0,00;0,0000;0,00;-56,70;DKK;0,00;0,00;0,00;1.441,64;1,00;UDBYTTE NOVO B 3 DKK/AKSJE;;214797716
335257290;2016-08-16;2016-08-12;2016-08-16;UDB.;NOVO B;Aktie;DK0060534915;70;3,00;0,0000;0,00;210,00;DKK;0,00;0,00;0,00;1.498,34;1,00;UDBYTTE NOVO B 3 DKK/AKSJE;;214797716
334516867;2016-08-11;2016-08-01;2016-08-10;UDB.;TNP;Aktie;BMG9108L1081;1.500;0,08;0,0000;0,00;800,61;DKK;0,00;0,00;0,00;1.288,34;1,00;UDBYTTE TNP 0.08 USD/AKSJE;;214766173
333176909;2016-08-03;2016-08-03;2016-08-05;KØBT;HM B;Aktie;SE0000106270;95;249,00;0,0000;46,23;-18.582,00;DKK;23.714,00;0,00;95,00;487,73;0,78;;;542257703
329003388;2016-07-05;2016-07-05;2016-07-07;KØBT;DANSKE;Aktie;DK0010274414;100;168,30;0,0000;29,00;-16.859,00;DKK;41.864,00;0,00;240,00;19.069,73;1,00;;;540445985
328252206;2016-07-01;2016-07-01;2016-07-05;SOLGT;COLO B;Aktie;DK0060448595;60;507,00;0,0000;30,42;30.389,58;DKK;0,00;900,12;0,00;35.928,73;1,00;;;540253503
327910244;2016-06-30;2016-06-30;2016-07-06;KØBT;TNP;Aktie;BMG9108L1081;1.500;4,75;0,0000;87,37;-47.973,07;DKK;7.138,00;0,00;1.500,00;5.539,15;6,72;;;540183676
327861042;2016-06-30;2016-06-30;2016-07-04;SOLGT;IVSO;Aktie;SE0001200015;280;61,00;0,0000;46,43;13.395,00;DKK;25.590,82;1.097,82;450,00;53.512,22;0,79;;;540157366
327632005;2016-06-29;2016-06-29;2016-07-01;KØBT;IVSO;Aktie;SE0001200015;140;60,25;0,0000;46,63;-6.713,00;DKK;41.514,00;0,00;730,00;40.117,22;0,79;;;540068072
327256099;2016-06-28;2016-06-27;2016-06-28;INDLØSNING VP LIKVID;EXQ ACC;Aktie;ZZ0060077758;2.600;18,00;0,0000;0,00;46.800,00;DKK;0,00;0,00;0,00;46.830,22;1,00;OPKØB EXQ;;214261028
327256097;2016-06-28;2016-06-27;2016-06-28;INDLØSNING OVERF. VP;EXQ ACC;Aktie;ZZ0060077758;2.600;18,00;0,0000;0,00;46.800,00;DKK;0,00;16.842,00;0,00;30,22;1,00;OPKØB EXQ;;55698625
325349765;2016-06-15;2016-06-15;2016-06-17;KØBT;IVSO;Aktie;SE0001200015;140;51,00;0,0000;47,03;-5.738,00;DKK;33.020,00;0,00;590,00;30,22;0,80;;;539154467
325052283;2016-06-14;2016-06-14;2016-06-16;KØBT;TRMD A;Aktie;GB00BZ3CNK81;150;63,00;0,0000;29,00;-9.479,00;DKK;34.941,50;0,00;420,00;5.768,22;1,00;;;539059525
324768096;2016-06-13;2016-06-13;2016-06-15;SOLGT;NAS;Aktie;NO0010196140;50;327,00;0,0000;47,04;12.989,61;DKK;12.359,48;3.931,52;50,00;15.247,22;0,80;;;538957256
320136293;2016-05-18;2016-05-18;2016-05-18;BYTTE INDLÆG  VP;EXQ ACC;Aktie;ZZ0060077758;2.600;0,00;0,0000;0,00;29.958,00;DKK;29.958,00;0,00;2.600,00;2.257,61;1,00;OPKØB EXQ 18 DKK/AK;;55599399
320136291;2016-05-18;2016-05-18;2016-05-18;BYTTE OVERF. VP;EXQ;Aktie;DK0060077758;2.600;0,00;0,0000;0,00;0,00;DKK;0,00;0,00;0,00;2.257,61;1,00;OPKØB EXQ 18 DKK/AK;;55599399
319196183;2016-05-11;2016-05-09;2016-05-11;UDBYTTESKAT;COLO B;Aktie;DK0060448595;60;0,00;0,0000;0,00;-72,90;DKK;0,00;0,00;0,00;2.257,61;1,00;UDBYTTE COLO B 4.5 DKK/AKSJE;;213836684
319196181;2016-05-11;2016-05-09;2016-05-11;UDB.;COLO B;Aktie;DK0060448595;60;4,50;0,0000;0,00;270,00;DKK;0,00;0,00;0,00;2.330,51;1,00;UDBYTTE COLO B 4.5 DKK/AKSJE;;213836684
317012826;2016-04-29;2016-04-29;2016-05-03;KØBT;IVSO;Aktie;SE0001200015;450;57,25;0,0000;48,04;-21.027,00;DKK;25.821,00;0,00;450,00;2.060,51;0,81;;;536302198
314658324;2016-04-19;2016-04-19;2016-04-19;BYTTE INDLÆG  VP;TRMD A;Aktie;GB00BZ3CNK81;270;0,00;0,0000;0,00;25.462,50;DKK;25.462,50;0,00;270,00;23.087,51;1,00;TILBUD 1 TORM A TIL 1 TRMD A;;55561971
314658322;2016-04-19;2016-04-19;2016-04-19;BYTTE OVERF. VP;TORM A ACC;Aktie;ZZ0060654812;270;0,00;0,0000;0,00;0,00;DKK;0,00;0,00;0,00;23.087,51;1,00;TILBUD 1 TORM A TIL 1 TRMD A;;55561971
314250988;2016-04-15;2016-04-13;2016-04-15;UDBYTTESKAT;MAERSK B;Aktie;DK0010244508;5;0,00;0,0000;0,00;-405,00;DKK;0,00;0,00;0,00;23.087,51;1,00;UDBYTTE MAERSK B 300 DKK/AKSJE;;213578387
314250986;2016-04-15;2016-04-13;2016-04-15;UDB.;MAERSK B;Aktie;DK0010244508;5;300,00;0,0000;0,00;1.500,00;DKK;0,00;0,00;0,00;23.492,51;1,00;UDBYTTE MAERSK B 300 DKK/AKSJE;;213578387
313836869;2016-04-14;2016-04-14;2016-04-14;BYTTE INDLÆG  VP;TORM A ACC;Aktie;ZZ0060654812;270;0,00;0,0000;0,00;25.462,50;DKK;25.462,50;0,00;270,00;21.992,51;1,00;TILBUD TORM A;;55557411
313836867;2016-04-14;2016-04-14;2016-04-14;BYTTE OVERF. VP;TORM A;Aktie;DK0060654812;270;0,00;0,0000;0,00;0,00;DKK;0,00;0,00;0,00;21.992,51;1,00;TILBUD TORM A;;55557411
311649742;2016-04-04;2016-04-04;2016-04-06;KØBT;DBK;Aktie;DE0005140008;100;14,70;0,0000;89,58;-11.062,62;DKK;4.838,50;0,00;250,00;21.992,51;7,46;;;534611822
309801560;2016-03-23;2016-03-21;2016-03-23;UDBYTTESKAT;NOVO B;Aktie;DK0060534915;70;0,00;0,0000;0,00;-120,96;DKK;0,00;0,00;0,00;33.055,13;1,00;UDBYTTE NOVO B 6.4 DKK/AKSJE;;213300173
309801558;2016-03-23;2016-03-21;2016-03-23;UDB.;NOVO B;Aktie;DK0060534915;70;6,40;0,0000;0,00;448,00;DKK;0,00;0,00;0,00;33.176,09;1,00;UDBYTTE NOVO B 6.4 DKK/AKSJE;;213300173
309386851;2016-03-22;2016-03-18;2016-03-22;UDBYTTESKAT;DANSKE;Aktie;DK0010274414;140;0,00;0,0000;0,00;-302,40;DKK;0,00;0,00;0,00;32.728,09;1,00;UDBYTTE DANSKE 8 DKK/AKSJE;;213289899
309386849;2016-03-22;2016-03-18;2016-03-22;UDB.;DANSKE;Aktie;DK0010274414;140;8,00;0,0000;0,00;1.120,00;DKK;0,00;0,00;0,00;33.030,49;1,00;UDBYTTE DANSKE 8 DKK/AKSJE;;213289899
309350411;2016-03-22;2016-03-22;2016-03-22;INDBETALING;;;;0;0,00;0,0000;0,00;30.000,00;DKK;0,00;0,00;0,00;31.910,49;1,00;OVERFORSEL - I;;213288755
308772434;2016-03-17;2016-03-17;2016-03-21;KØBT;COLO B;Aktie;DK0060448595;60;491,00;0,0000;29,46;-29.489,46;DKK;29.489,46;0,00;60,00;1.910,49;1,00;;;533782772
307701831;2016-03-11;2016-03-11;2016-03-11;INDBETALING;;;;0;0,00;0,0000;0,00;30.000,00;DKK;0,00;0,00;0,00;31.399,95;1,00;OVERFORSEL - I;;213223526
307407578;2016-03-09;2016-03-09;2016-03-11;KØBT;EXQ;Aktie;DK0060077758;1.300;11,50;0,0000;29,00;-14.979,00;DKK;29.958,00;0,00;2.600,00;1.399,95;1,00;;;533268598
307226896;2016-03-08;2016-03-08;2016-03-10;KØBT;EXQ;Aktie;DK0060077758;1.300;11,50;0,0000;29,00;-14.979,00;DKK;14.979,00;0,00;1.300,00;16.378,95;1,00;;;533183969
302701746;2016-02-10;2016-02-10;2016-02-10;INDBETALING;;;;0;0,00;0,0000;0,00;25.000,00;DKK;0,00;0,00;0,00;31.357,95;1,00;OVERFORSEL - I;;212942556
301715221;2016-02-04;2016-02-04;2016-02-08;KØBT;NOVO B;Aktie;DK0060534915;70;346,00;0,0000;29,00;-24.249,00;DKK;24.249,00;0,00;70,00;6.357,95;1,00;;;530773818
301386251;2016-02-03;2016-02-03;2016-02-03;INDBETALING;;;;0;0,00;0,0000;0,00;25.000,00;DKK;0,00;0,00;0,00;30.606,95;1,00;OVERFORSEL - I;;212891272
300021923;2016-01-27;2016-01-27;2016-01-29;KØBT;NAS;Aktie;NO0010196140;100;247,00;0,0000;15,00;-19.570,47;DKK;24.718,95;0,00;100,00;5.606,95;0,79;;;530125145
298842617;2016-01-20;2016-01-20;2016-01-20;INDBETALING;;;;0;0,00;0,0000;0,00;25.000,00;DKK;0,00;0,00;0,00;25.177,42;1,00;OVERFORSEL - I;;212689649
297962147;2016-01-14;2016-01-14;2016-01-18;KØBT;DANSKE;Aktie;DK0010274414;140;178,50;0,0000;15,00;-25.005,00;DKK;25.005,00;0,00;140,00;177,42;1,00;;;529191117
297192864;2016-01-11;2016-01-11;2016-01-13;KØBT;TORM A;Aktie;DK0060654812;270;94,25;0,0000;15,00;-25.462,50;DKK;25.462,50;0,00;270,00;25.182,42;1,00;;;528851436
296780406;2016-01-08;2016-01-08;2016-01-08;INDBETALING;;;;0;0,00;0,0000;0,00;25.000,00;DKK;0,00;0,00;0,00;50.644,92;1,00;BASISBANK;;212596265























